h7w11
B BSB BSB B
BBBBBBBBBBB
BSBSBSBSBSB
SSSSSSSSSSS
  B  B  B  
S S S S S S
BBBSBBBSBBB
x
